####################
#S#  ##      #    E#
# # ## ##### # #####
#   ##     # #   # #
### ####### ### # # #
# #    #   #   # #  #
# #### # ### ### # ##
#    # # # #     #  #
#### # # # ##### ## #
#    # #   #   #    #
## ### ####### ######
#      #      #    # #
# ####### ####### # #
# #      # #      # #
# # ###### # ####### #
# # #    # #         #
# # # ### ######### ##
#   # #   #         # 
##### ### ######### # 
#                  # #
######################

