##########
#S       #
# ###### #
#E      ##
##########
